++++++++++++++++++++
+                  +
+          g       +
+          g       +
+fff       g       +
+f         g       +
+ff        g       +
+f         g       +
+f                 +
+                  +
++++++++++++++++++++
