++++++++++++++++++++
+           #     e+
+  bb   f   # k g  +
+           #      +
+           #    b +
+g    w#    ## b  b+
+  b   #  b        +
+f  b  #           +
+      #  e    f  f+
+ f  c #           +
++++++++++++++++++++
