++++++++++++++++++++
+                  +
+                  +
+       eggf       +
+     gggg f       +
+          f       +
+                  +
+                  +
+                  +
+                  +
++++++++++++++++++++
