++++++++++++++++++++
+                  +
+     c          g +
+                  +
+        ##        +
+        ##        +
+                  +
+            e     +
+ f                +
+                  +
++++++++++++++++++++
