++++++++++++++++++++
+                  +
+                  +
+     gggggf       +
+          f       +
+          f       +
+                  +
+                  +
+                  +
+                  +
++++++++++++++++++++
