++++++++++++++++++++
+             k  g +
+             bb   +
+                  +
+                  +
+                  +
+                  +
+                  +
+              f   +
+                  +
++++++++++++++++++++