++++++++++++++++++++
+       vf         +
+     b  f  #     e+
+   u   g   #      +
+e   b b c  #   k  +
+   b       #   bb +
+        f  #      +
+     ###          +
+ k    #           +
+         b       f+
++++++++++++++++++++
