++++++++++++++++++++
+ f   e            +
+ f   e            +
+     e            +
+     e            +
+     e            +
+ f   e            +
+ f   e            +
+     e            +
+     e            +
++++++++++++++++++++
