++++++++++++++++++++
+     #        #  g+
+ g       w    # c +
+  f           #   +
+##  g#       ###  +
+ b   #            +
+    k#bbbbb#      +
+           #      +
+f g        #      +
+    ge     #      +
++++++++++++++++++++
