++++++++++++++++++++
+   #     v   k g  +
+ c # #       bb   +
+   # #            +
+## b #      e     +
+     #            +
+ #####bb       f  +
+f    f bbb t      +
+  ##              +
+ g#  f ###        +
++++++++++++++++++++