++++++++++++++++++++
+g                 +
+f                 +
+                  +
+                  +
+         c        +
+                  +
+                  +
+   e              +
+                  +
++++++++++++++++++++
