++++++++++++++++++++
+                  +
+                  +
+                  +
+        #c        +
+bbb bbbb###bbbb bb+
+         e#       +
+                  +
+                  +
+                  +
++++++++++++++++++++
