++++++++++++++++++++
+    f    u        +
+    #      #      +
+    #      #      +
+ c  # e    #      +
+    #    k g      +
+###b#  ### #      +
+       #   #      +
+ f    b#  b#####  +
+               b  +
++++++++++++++++++++
