++++++++++++++++++++
+     #        #  g+
+ g       w    # c +
+  f           #   +
+##  g#       ###  +
+ b   #            +
+    k#bbbbb       +
+          bb      +
+f g       bb      +
+    g  e   b      +
++++++++++++++++++++
