++++++++++++++++++++
+ c #     v   k  g +
+   # #       bb   +
+   # #            +
+## b #            +
+     #            +
+ #####bb          +
+       b   t      +
+ f##          f   +
+ g#               +
++++++++++++++++++++