++++++++++++++++++++
+c #  #   #   #   v+
+  #  #   #   #f   +
+bb#      #   #    +
+  #  #b  #e  #b   +
+  #  #   #    b   +
+gf# b#     #  b   +
+bb#  #  #  #  b   +
+  b  #  #  #      +
+  #b #  #  #u    g+
++++++++++++++++++++
