++++++++++++++++++++
+gf                +
+gf                +
+gf                +
+                  +
+                  +
+                  +
+                  +
+                  +
+                  +
++++++++++++++++++++
