++++++++++++++++++++
+ e#       #f      +
+ ##       #       +
+ #u       #    k  +
+f#b   #   v       +
+                  +
+#####  t     ++ +++
+g   b b#     +    +
+ c b   #     +eb  +
+       #  b u f  g+
++++++++++++++++++++
