++++++++++++++++++++
+   #         k    +
+ c #              +
+   #         bb  f+
+##bb    t    #    +
+             #    +
+ ### t b     #    +
+f    f bbb   #  ##+
+####         #  g +
+ g#  f ###   #e   +
++++++++++++++++++++