++++++++++++++++++++
+   #     v   k    +
+   # #       bb   +
+   # #            +
+## b #     be     +
+             b    +
+ #####bb          +
+       b   t      +
+  ##              +
+  #    ###        +
++++++++++++++++++++
