++++++++++++++++++++
+       w#u       g+
+                  +
+  ##g### ######   +
+  b   # b # v #   +
+  #   # c #   #b  +
+  # t #   #   f b +
+  ##########g##   +
+        e         +
+f                 +
++++++++++++++++++++
