++++++++++++++++++++
+ c #     v   k  g +
+   # #       bb   +
+   # #            +
+## b #      e     +
+     #            +
+ #####bb          +
+ f     bbb t      +
+ f##          f   +
+ g#    ###        +
++++++++++++++++++++
