++++++++++++++++++++
+ c #         k  g +
+   # #       bb   +
+   # #            +
+   b #            +
+                  +
+ #                +
+ f         t      +
+              f   +
+                  +
++++++++++++++++++++