++++++++++++++++++++
+ c #         k  g +
+   # #       bb   +
+   # #            +
+## b #            +
+     #            +
+ #####            +
+           t      +
+ f##          f   +
+ g#               +
++++++++++++++++++++