++++++++++++++++++++
+ c #     v   k  g +
+   # #       bb   +
+   # #            +
+## b #            +
+     #            +
+ #####bb          +
+       bbb t      +
+ f##          f   +
+ g#    ###        +
++++++++++++++++++++