++++++++++++++++++++
+          v       +
+                  +
+       e  f       +
+          f       +
+          f       +
+                  +
+                  +
+                  +
+                  +
++++++++++++++++++++
