++++++++++++++++++++
+   #         k    +
+ c #              +
+   #         bb  f+
+## b    t    #    +
+             #e   +
+ ## ##bb     #    +
+f    f bbb   #####+
+####            g +
+ g#  f ###        +
++++++++++++++++++++